11111111
10000001
100P0001
1C0000C1
100E0001
11111111