1111111111111111111111111
10000000000C0010011000001
10000C1000100000011111001
100000100C000000010E00101
1000000000000000010000001
1000000000000000010000001
1000000P00000000010000001
1000000000000000010000001
1111111111111111111111111