1111111111111111111111111
10000000000C0010001000001
10000CX000X00000001111001
100000X00C000000000E00101
10000000000000000X0000001
10000000000000000X0000001
1000000P000000000X0000001
10000000000000000X0000001
10000000000000000X0000001
10000000000000000X0000001
10000000000000000X0000001
10000000000000000X0000001
10000000000000000X0000001
1111111111111111111111111